###########
#########..
@.CC$$.SS..
...........
...........
