...%.
.$.%.
.@#%.
..C%C
...%.
###%#
###S#

............
.......C....
.@.C.%%%#%..
.....%%%#%..
.CCCC%%%%%..
............
............

