.######..
...%.....
..#%#.C..
...@.....
.........
